+---+---+---+---+---+
|(A)| D   1   1   F |
+   +   +   +---+---+
| 1 | 1 | 1   E   1 |
+   +   +---+---+   +
| 2 | 1 | 3   3   2 |
+   +   +   +---+   +
| B   2   3 | 2   1 |
+---+---+---+   +---+
| C   1   2   3   G |
+---+---+---+---+---+
